{
    "type": {
        "name": "protocol-map",
        "version": 1
    },
    "content": {
        "name": "15w36c",
        "protocol": 69,
        "base": 47,
        "map": {
            "clientbound": {
                "0x22": "0x23",
                "0x23": "0x24",
                "0x24": "0x25",
                "0x25": "0x26"
            },
            "serverbound": {
                "0x08": "0x09",
                "0x09": "0x0A",
                "0x0A": "0x0B",
                "0x0B": "0x0C",
                "0x0C": "0x0D",
                "0x0D": "0x0E",
                "0x0E": "0x0F",
                "0x0F": "0x10",
                "0x10": "0x11",
                "0x11": "0x12",
                "0x12": "0x13",
                "0x13": "0x14",
                "0x14": "0x15",
                "0x15": "0x16",
                "0x16": "0x17",
                "0x17": "0x18",
                "0x18": "0x19",
                "0x19": "0x1A"
            }
        }
    }
}