{
    "type": {
        "name": "protocol-map",
        "version": 1
    },
    "content": {
        "name": "15w40b",
        "protocol": 76,
        "base": 47,
        "map": {
            "clientbound": {
                "0x00": "0x1F",
                "0x01": "0x24",
                "0x02": "0x0F",
                "0x03": "0x43",
                "0x04": "0x3C",
                "0x05": "0x42",
                "0x06": "0x3E",
                "0x07": "0x33",
                "0x08": "0x2E",
                "0x09": "0x37",
                "0x0A": "0x2F",
                "0x0B": "0x06",
                "0x0C": "0x05",
                "0x0D": "0x47",
                "0x0E": "0x00",
                "0x0F": "0x03",
                "0x10": "0x04",
                "0x11": "0x01",
                "0x12": "0x3B",
                "0x13": "0x30",
                "0x14": "0x29",
                "0x15": "0x26",
                "0x16": "0x28",
                "0x17": "0x27",
                "0x18": "0x48",
                "0x19": "0x34",
                "0x1B": "0x3A",
                "0x1C": "0x39",
                "0x1D": "0x4A",
                "0x1E": "0x31",
                "0x1F": "0x3D",
                "0x20": "0x49",
                "0x21": "0x20",
                "0x22": "0x10",
                "0x23": "0x0B",
                "0x24": "0x0A",
                "0x25": "0x08",
                "0x27": "0x1B",
                "0x28": "0x21",
                "0x29": "0x23",
                "0x2A": "0x22",
                "0x2B": "0x1E",
                "0x2C": "0x02",
                "0x2D": "0x13",
                "0x2E": "0x12",
                "0x2F": "0x16",
                "0x30": "0x14",
                "0x31": "0x15",
                "0x32": "0x11",
                "0x33": "0x45",
                "0x34": "0x25",
                "0x35": "0x09",
                "0x36": "0x2A",
                "0x37": "0x07",
                "0x38": "0x2D",
                "0x39": "0x2B",
                "0x3A": "0x0E",
                "0x3B": "0x3F",
                "0x3C": "0x41",
                "0x3D": "0x38",
                "0x3E": "0x40",
                "0x3F": "0x18",
                "0x40": "0x19",
                "0x41": "0x0D",
                "0x42": "0x2C",
                "0x43": "0x36",
                "0x44": "0x35",
                "0x45": "0x44",
                "0x46": "0x1D",
                "0x47": "0x46",
                "0x48": "0x32"
            },
            "serverbound": {
                "0x00": "0x0A",
                "0x02": "0x09",
                "0x03": "0x0E",
                "0x04": "0x0B",
                "0x05": "0x0D",
                "0x06": "0x0C",
                "0x07": "0x10",
                "0x08": "0x19",
                "0x09": "0x14",
                "0x0A": "0x17",
                "0x0B": "0x11",
                "0x0C": "0x12",
                "0x0D": "0x07",
                "0x0E": "0x06",
                "0x0F": "0x04",
                "0x10": "0x15",
                "0x11": "0x05",
                "0x12": "0x16",
                "0x13": "0x0F",
                "0x14": "0x00",
                "0x15": "0x03",
                "0x16": "0x02",
                "0x17": "0x08",
                "0x19": "0x13"
            }
        }
    }
}