{
    "type": {
        "name": "protocol-map",
        "version": 1
    },
    "content": {
        "name": "17w31a",
        "protocol": 336,
        "base": 335,
        "map": {
            "clientbound": {
                "0x2B": "0x2C",
                "0x2C": "0x2D",
                "0x2D": "0x2E",
                "0x2E": "0x2F",
                "0x2F": "0x30",
                "0x30": "0x31",
                "0x31": "0x32",
                "0x32": "0x33",
                "0x33": "0x34",
                "0x34": "0x35",
                "0x35": "0x36",
                "0x36": "0x37",
                "0x37": "0x38",
                "0x38": "0x39",
                "0x39": "0x3A",
                "0x3A": "0x3B",
                "0x3B": "0x3C",
                "0x3C": "0x3D",
                "0x3D": "0x3E",
                "0x3E": "0x3F",
                "0x3F": "0x40",
                "0x40": "0x41",
                "0x41": "0x42",
                "0x42": "0x43",
                "0x43": "0x44",
                "0x44": "0x45",
                "0x45": "0x46",
                "0x46": "0x47",
                "0x47": "0x48",
                "0x48": "0x49",
                "0x49": "0x4A",
                "0x4A": "0x4B",
                "0x4B": "0x4C",
                "0x4C": "0x4D",
                "0x4D": "0x4E",
                "0x4E": "0x4F"
            },
            "serverbound": {
                "0x02": "0x01",
                "0x03": "0x02",
                "0x04": "0x03",
                "0x05": "0x04",
                "0x06": "0x05",
                "0x07": "0x06",
                "0x08": "0x07",
                "0x09": "0x08",
                "0x0A": "0x09",
                "0x0B": "0x0A",
                "0x0C": "0x0B",
                "0x0D": "0x0C",
                "0x0E": "0x0D",
                "0x0F": "0x0E",
                "0x10": "0x0F",
                "0x11": "0x10",
                "0x12": "0x11"
            }
        }
    }
}