{
    "type": {
        "name": "protocol-map",
        "version": 1
    },
    "content": {
        "name": "17w45a",
        "protocol": 343,
        "base": 340,
        "map": {
            "clientbound": {
                "0x0F": "0x0E",
                "0x10": "0x0F",
                "0x49": "0x4A",
                "0x4A": "0x4B",
                "0x4B": "0x4C",
                "0x4C": "0x4D",
                "0x4D": "0x4E",
                "0x4E": "0x4F",
                "0x4F": "0x50"
            },
            "serverbound": {
                "0x02": "0x01",
                "0x03": "0x02",
                "0x04": "0x03",
                "0x05": "0x04",
                "0x06": "0x05",
                "0x07": "0x06",
                "0x08": "0x07",
                "0x09": "0x08",
                "0x0A": "0x09",
                "0x0B": "0x0A",
                "0x0C": "0x0B",
                "0x0D": "0x0C",
                "0x0E": "0x0D",
                "0x0F": "0x0E",
                "0x10": "0x0F",
                "0x11": "0x10",
                "0x12": "0x11",
                "0x13": "0x12",
                "0x14": "0x13",
                "0x15": "0x14",
                "0x16": "0x15",
                "0x17": "0x16",
                "0x18": "0x17",
                "0x19": "0x18",
                "0x1A": "0x19",
                "0x1B": "0x1A",
                "0x1C": "0x1B",
                "0x1D": "0x1C",
                "0x1E": "0x1D",
                "0x1F": "0x1E",
                "0x20": "0x1F"
            }
        }
    }
}