{
    "type": {
        "name": "protocol-map",
        "version": 1
    },
    "content": {
        "name": "19w05a",
        "protocol": 458,
        "base": 404,
        "map": {
            "clientbound": {
                "0x14": "0x59",
                "0x2C": "0x2D",
                "0x2D": "0x2E",
                "0x2E": "0x2F",
                "0x2F": "0x30",
                "0x30": "0x31",
                "0x31": "0x32",
                "0x32": "0x33",
                "0x33": "0x34",
                "0x34": "0x35",
                "0x35": "0x36",
                "0x36": "0x37",
                "0x37": "0x38",
                "0x38": "0x39",
                "0x39": "0x3A",
                "0x3A": "0x3B",
                "0x3B": "0x3C",
                "0x3C": "0x3D",
                "0x3D": "0x3E",
                "0x3E": "0x3F",
                "0x3F": "0x40",
                "0x40": "0x41",
                "0x41": "0x42",
                "0x42": "0x43",
                "0x43": "0x44",
                "0x44": "0x45",
                "0x45": "0x46",
                "0x46": "0x47",
                "0x47": "0x48",
                "0x48": "0x49",
                "0x49": "0x4A",
                "0x4A": "0x4B",
                "0x4B": "0x4C",
                "0x4C": "0x4D",
                "0x4D": "0x4E",
                "0x4E": "0x50",
                "0x4F": "0x51",
                "0x50": "0x52",
                "0x51": "0x53",
                "0x52": "0x54",
                "0x53": "0x55",
                "0x54": "0x56",
                "0x55": "0x57"
            },
            "serverbound": {}
        }
    }
}