{
    "type": {
        "name": "protocol-map",
        "version": 1
    },
    "content": {
        "name": "20w20a",
        "protocol": 716,
        "base": 578,
        "map": {
            "clientbound": {
                "0x43": "0x44",
                "0x44": "0x45",
                "0x45": "0x46",
                "0x46": "0x47",
                "0x47": "0x48",
                "0x48": "0x49",
                "0x49": "0x4A",
                "0x4A": "0x4B",
                "0x4B": "0x4C",
                "0x4C": "0x4D",
                "0x4D": "0x4E",
                "0x4E": "0x43"
            },
            "serverbound": {
                "0x0F": "0x10",
                "0x10": "0x11",
                "0x11": "0x12",
                "0x12": "0x13",
                "0x13": "0x14",
                "0x14": "0x15",
                "0x15": "0x16",
                "0x16": "0x17",
                "0x17": "0x18",
                "0x18": "0x19",
                "0x19": "0x1A",
                "0x1A": "0x1B",
                "0x1B": "0x1C",
                "0x1C": "0x1D",
                "0x1D": "0x1E",
                "0x1E": "0x1F",
                "0x1F": "0x20",
                "0x20": "0x21",
                "0x21": "0x22",
                "0x22": "0x23",
                "0x23": "0x24",
                "0x24": "0x25",
                "0x25": "0x26",
                "0x26": "0x27",
                "0x27": "0x28",
                "0x28": "0x29",
                "0x29": "0x2A",
                "0x2A": "0x2B",
                "0x2B": "0x2C",
                "0x2C": "0x2D",
                "0x2D": "0x2E"
            }
        }
    }
}